0
10 15
- - - - - - - - - - - - - - - 
- - - - - - 0 - 0 - - - - - - 
- - - - 0 0 0 0 - - 1 - - - - 
- - - - 0 - 0 0 0 0 0 - - - - 
- 0 0 - 3 - 0 0 - - 0 - - - - 
- - 0 - - 0 0 0 - 0 0 0 - - - 
- - 0 0 0 0 0 0 0 0 0 - - - - 
- - - 0 0 0 - - - - - - - - - 
- - - - - - - - - - - - - - - 
- - - - - - - - - - - - - - - 
